111111111111111111111
1C0000000000000000011
1111110P0000000000011
100000010111110011111
100000000000110E11111
111000111000011110011
111101111000011100011
111000111000011100011
111000111000011000011
111000111000010000011
1110C0111000000000C11
111111111111111111111