1111111111
1P10000001
1110000001
1000000001
1000000001
1C000000E1
1111111111