111111111111111111111
1C0000000010000000011
11111100P000000000011
100000010111110011111
100000000000110E11111
111000111000011110011
111101111000011100011
111000111000011100011
111000111000001000011
111000111000000000011
1110C0111000000000C11
111111111111111111111