111111111111111111111
101000000000000000011
111000000000000000011
100000000001111110011
1C000000000011E000011
111000111000011100011
1111C1111000011100011
111000111000011100011
111000111000001000011
111000111000000000011
111000111P00000000011
111111111111111111111