1111111
1P00001
100C001
10CEC01
100C001
1000001
1111111