111111111111111111111
10000C0000E0000000011
11111100P000000000011
100000010111110011111
100000000000110001111
111000111000011100011
111101111000011100011
111000111000011100011
111000111000001000011
111000111000000000011
111000111000000000011
111111111111111111111