1111111111111111111111111111111111111111
1P00000C00000000000111111111111111111111
1110000000000000000111111111111111111111
10000E0001111110011111111111111111111111
1000000000001100011111111111111111111111
1110001110000111000111111111111111111111
1111011110000111000111111111111111111111
1110001110000111000111111111111111111111
1110001110000010000111111111111111111111
1110001110000000000111111111111111111111
1110001110000000000111111111111111111111
1111111111111111111111111111111111111111
1111111111111111111111111111111111111111
1111111111111111111111111111111111111111
1111111111111111111111111111111111111111
1111111111111111111111111111111111111111
1111111111111111111111111111111111111111
1111111111111111111111111111111111111111
1111111111111111111111111111111111111111
1111111111111111111111111111111111111111
1111111111111111111111111111111111111111
