111111111111111111111
1010000C0000000000011
111000000000000000011
10000E000111111001111
1000000P0000110001111
111000111000011100011
111101111000011100011
111000111000011100011
111000111000001000011
111000111000000000011
111000111000000000011
111111111111111111111